11111111111111111
1P01000000E000001
10001000000000001
10010000000000001
1000011111000M001
10001100000000001
1000000000C000001
10000000000000001
11111111111111111