11111111111111111
1001000E000000001
10010000000C000C1
10C01000M00C00001
10010000000000001
10000111110000001
1P00110000000C001
1000000C000000001
1000000000C000001
11111111111111111