11111111111111111
1P100M0100E001001
1000100001000C001
11000101000101001
100000C0010M00101
10010001000010001
10C0001000C000101
10100M01000010001
11111111111111111