11111111111111111
1P10000100E001001
1000100001000C001
11000101000101001
100000C0010000101
10010001000010001
10C0001000C000101
10100001000010001
11111111111111111